################################################################
#                                                              #
#                                                              #
#                                                              #
#                                                              #
#                                                              #
#                                                              #
#                                                              #
#                                                              #
#                                                              #
#                                                              #
#                                                              #
#                                                              #
#                                                              #
#                                                              #
#                                                              #
#                                                              #
#                                                              #
#                                                              #
#                                                              #
#                                                              #
#                                                              #
#                                                              #
#                                                              #
#                                                              #
#                                                              #
#                                                              #
#                                                              #
#                                                              #
###########                                           ##########
###########                                           ##########
###########                                           ##########
###########                                            #########
###########                                                    #
#                                                              #
#                                                              #
#                                                              #
#                                                              #
#P                                                          E  #
#                                                              #
###############                 #                   ############
###############                                     ############
###############^^^^^^^^^^^^^^^^^^^^^^^^^^^^^^^^^^^^^############
################################################################

