###############################################################
#                                                             #
#                                                             #
#                                                             #
#                 E                                           #
#            ############                                     #
#                                                             #
#                                                             #
#                                                             #
#                                                             #
#              ######       ######       ######               #
#              ######       ######       ######               #
#              ######       ######       ######               #
#              ######       ######       ######               #
#              ######       ######       ######               #
#              ######       ######       ######               #
#              ######       ######       ######               #
#              ######       ######       ######               #
#              ######       ######       ######               #
#              ######       ######       ######               #
#              ######       ######       ######               #
#                                                             #
#                                                             #
#                                                             #
#                                                             #
#       #######################################################
#       #######################################################
#       ############                ######                    #
#                                   ######                    #
#                                                             #
#                       #######                 ########      #
#                       #######                 ########      #
########################################################      #
########################################################      #
######                                                        #
######                                                        #
######   P                                                    #
######                                                        #
###############################################################
###############################################################

