################################################################
#                                                              #
#                                                              #
#                 E                                            #
#                                                              #
#            ############                                      #
#                                                              #
#                                                              #
#                                                              #
#                                                              #
#              ######       ######       ######                #
#              ######       ######       ######                #
#              ######       ######       ######                #
#              ######       ######       ######                #
#              ######       ######       ######                #
#              ######       ######       ######                #
#              ######       ######       ######                #
#              ######       ######       ######                # 
#              ######       ######       ######                #
#              ######       ######       ######                #
#              ######       ######       ######                #
#              ######       ######       ######                #
#              ######       ######       ######                #
#              ######       ######       ######                #
#              ######       ######       ######                #
#                                                              #
#                                                              #
#                                                              #
#                                                              #
#       ########################################################
#       ########################################################
#       ############                ######                     #
#                                   ######                     #
#                                                              #
#                       #######                 ########       #
#                       #######                 ########       #
########################################################       #
########################################################       #
######                                                         #
######                                                         #
######   P                                                     #
######                                                         #
################################################################
################################################################

