################################################################
#                                                              #
#                                                              #
#                                                              #
#                                                              #
#                                                              #
#                                                              #
#                                                              #
#                                                              #
#                                                              #
#                                                              #
#                                                              #
#                                                              #
#                                                              #
#            K                                                 #
#                                                              #
#                                                              #
#                                                              #
#                                                              #
#                                                              #
#                                                              #
#                                                              #
#                                                              #
#                                                              #
#                                                              #
#                                                              #
#                                                              #
#                                                              #
#                                                              #
#                                                              #
#                             E                                #
#                                                              #
#                     ################                         #
#                                                              #
#                                                              #
#                                                              #
#                                                              #
#                                             ##################
#                                           ####################
# P                                        #####################
#                                       ########################
#                                  ############################# 
#                ###############################################
################################################################
