################################################################
#                                                              #
#                                                              #
#                                                              #
#                                                              #
#                                                              #
#                                                              #
#                                                              #
#                                                              #
#                                                              #
#                                                              #
#                                                              #
#                                                              #
#                                                              #
#                                                              #
#                                                              #
#                                                              #
#                                                              #
#                                                              #
#                                                              #
#                                                              #
#                                                              #
#                                                              #
#                                                              #
#                                                              #
#                                                              #
#                                                              #
#                                                              #
#                                                   <###########
###########>                                        <###########
###########>                                        <###########
###########>                                        <###########
###########>                                          ##########
##########                                                     #
#                                                              #
#                                                              #
#                                                              #
#                                                              #
#P                                                          E  #
#                                                              #
###############                 #                   ############
###############                                     ############
###############^^^^^^^^^^^^^^^^^^^^^^^^^^^^^^^^^^^^^############
################################################################

