################################################################
#             ##################################################
#             ##################################################
#             ##################################################
#             ####       VVVV      #############################
#             ####                 #############################
#             ####        P        #############################
########     <####                 #############################
########>    <####       ####      #############################
########>    <####       ####      #############################
########>    <####       ####      #############################
########>    <####       ####      #############################
########>    <####       ####      #############################
########>    <####      <####      #############################
########>    <####      <####      #####VVVVVVVVVVVVVVVVVVVVVVV#
#             ####       ####                                  # 
#             ####       ####                                  #
#             ####       ####                                  #
#    #############>      ####                                  #
#   <#############      <####                                  #
#   <##                 <####                                  #
#   <##                 <####                                  #
#   <##    ##################                                  #
#   <##    ##################^^^^^                             #
#          #######################^^^^^                        #
#>         ####                 #######^^^^^^^^^        E      #
#>         ####                      ############              #
#>         ####                                #################
#>         ####                                                #
#>   ##########                                                #
##^^^##########                                                #
###############                                                #
#                                                              #
#                                                              #
#                                                              #
#                                                              #
#                                                              #
#                                                              #
#                                                              #
#                                                              #
#                                                              #
#                                                              #
#                                                              #
################################################################
 
