###############################################################
#                                                             #
#                                                             #
#                                                             #
#                                                             #
#                                                             #
#                                                             #
#                                                             #
#                                                             #
#                                                             #
#                                                             #
#                                                             #
#                                                             #
#                                                             #
#                                                             #
#                                                             #
#                                                             #
#                                                             #
#                                                             #
#                                                             #
#                                                             #
#                                                             #
#                                                             #
#                                                             #
#                                     E                       #
#                                ############                 #
#                                ###############              #
#                                 ##################          #
#                                  ##################         #
#                                   #################         #
#                                   #################         #
#                                   #################         #
#                                   #################         #
#                                                             #
#                                                             #
#####       P                                                 #
######                                                        #
##########                                                    #
##########                                                    #
###############################################################

