###############################################################
#                                                             #
#                                                             #
#                                                             #
#                                                             #
#                                                             #
#                                                             #
#                                                             #
#                                                             #
#                                                             #
#                                                             #
#                                                             #
#                                                             #
#                                                             #
#                                                             #
#                                                             #
#                                                             #
#                                                             #
#                                                             #
#                                                             #
#                                                             #
#                                                             #
#                                                             #
#                                                             #
#                                                             #
#                                                             #
#                                                             #
#                             E                               #
#                     ################                        #
#                                                             #
#                                                             #
#                                                             #
#                                                             #
#                                                             #
#                                                             #
# P                                           #################
#                                       #######################
#                                  ############################ 
#                ##############################################
###############################################################

