################################################################
#                                                              #
#                                                              #
#                                                              #
#                                                              #
#                                                              #
#                                                              #
#                                                              #
#                                                              #
#                                                              #
#                                                              #
#                                                              #
#                                                              #
#                                                              #
#                                                              #
#                                                              #
#                                                              #
#                                                              #
#                                                              #
#                                                              #
#                                                              #
#                                                              #
#                                                              #
#                                                              #
#                                                              #
#                                                              #
#                                                              #
#                                      E                       #
#                                                              #
#                                 ############                 #
#                                 ###############              #
#                                  ##################          #
#                                   ##################         #
#                                    #################         #
#                                    #################         #
#                                    #################         #
#                                     ################         #
#                                                              #
#                                                              #
#####       P                                                  #
######                                                         #
##########                                                     #
##########                                                     #
################################################################

