##################################################
#                                                #
#                                                #
#                                                #
#                                                #
#                                                #
#                                                #
#                                                #
#                                                #
#                                                #
#                                                #
#                                                #
#                                                #
#                                                #
#                                                #
#                                                #
#                                                #
#                                                #
#                                                #
#                                                #
#                                                #
#                                                #
#                                                #
#                                                #
#                                                #
#                                                #
#                                                #
#                                                #
#                                                #
#                                                #
#                                                #
#                                                #
#                                                #
#                                                #
#                                                #
#                                                #
#                                                #
#               #####                            #
#P                                              E#
##################################################

