###############################################################
#                                                             #
#                                                             #
#                                                             #
#                                                             #
#                                                             #
#                                                             #
#                                                             #
#                                                             #
#                                                             #
#                                                             #
#                                                             #
#                                                             #
#                                                             #
#                                                             #
#                                                             #
#                                                             #
#                                                             #
#                                                             #
#                                                             #
#                                                             #
#                                                             #
#                                                             #
#                                                             #
#                                                             #
#                                                             #
###########                                          ##########
###########                                          ##########
###########                                          ##########
###########                                           #########
##########                                                    #
#                                                             #
#                                                             #
#                                                             #
#P                                                            #
#                                                           E #
###############                                    ############
###############                                    ############
###############^^^^^^^^^^^^^^^^^^^^^^^^^^^^^^^^^^^^############
###############################################################

