###############################################################
#                                                             #
#                                                             #
#                                                             #
#                                                             #
#                                                             #
#                                                             #
#                                                             #
#    P                                                        #
#                                                             #
##########               ###                    ###           #
##########               ###                    ###           #
#########                                                     #
########                                                      #
#######                                                       #
######                                                        #
#####                                                         #
####                                                          #
####^^^^^^^^^^^^^^^^^^^^^^^^^^^^^^^^^^^^^^^^^^^^^^^^^^^^^   ^^#
#########################################################   ###
#########################################################   ###
#                       ###            ###                  ###
#                       ###            ###                  ###
#                       vvv            vvv                  ###
#                                                           ###
#                                                           ###
#                                                           ###
#        ###            ###            ###            #########
#^^^^    ###^^^^^^^^^^^^###^^^^^^^^^^^^###^^^^^^^^^^^^#########
#####    ######################################################
#####                                                         #
#####                                                         #
#####                                                         #
#####                                                         #
#####                                                         #
#####                                                         #
#####                                                         #
#####^^^^^^^^##                                               #
###############                                               #
#                                                             #
#                                                             #
#                                                             #
#                                                             #
#                                                             #
#                                                             #
#                                                    E        #
#                                                             #
###############################################################


